1111111111111111111111111111111111
1111111111111111111111111111111111
1100000000000000000000000000000011
1100000000011110000000000000000011
1100000000000000000000000000000011
1100000000000000000000000000000011
1100000000011110000000010000000011
1100000000000010000000010000000011
1100000000010010000000010000000011
1100000000011110000000011110000011
1100000000000000000000000000000011
1100000000000000000000100000000011
11000000000X0000000111100000000011
1100000000000000000000100000000011
1101000000000000002000000000000011
1100000000000000000000001000000011
1100010001000000000000001000000011
1100010001000000000000001000000011
1100010001000000000000001000000011
1100000000000000000001111000000011
1100000000000000000000000000000011
1100000000000000000000000000000011
1111111111111111111111111111111111
1111111111111111111111111111111111
